#pragma: setsize=10 layout=Enumerate depth=1 nosort
# maxsets=6
#☹☺←→↺
#-ᏍᎪ, -Ꮝ, -Ꮷ, -Ꮚ, -Ꮎ, -Ꮂ, 

#random: cas=ᎢᏤᎢᏳᏍᏗ, ᎤᏁᎦ, ᎤᏬᏗᎨ, ᎠᎬᎿᎨ, ᎠᏓᎶᏂᎨ, ᎠᏓᎶᏂᎨ ᎤᏍᎪᎸ
#random: cis=ᎢᏤᎢᏳᏍᏗ, ᎤᏁᎦ, ᎤᏬᏗᎨ, ᎬᎿᎨ, ᏓᎶᏂᎨ, ᏓᎶᏂᎨ ᎤᏍᎪᎸ

#random: cap=ᎠᏂᏤᎢᏳᏍᏗ, ᎤᏂᏁᎦ, ᎤᏃᏗᎨ, ᎠᏂᎬᎿᎨ, ᎠᏂᏓᎶᏂᎨ, ᎠᏂᏓᎶᏂᎨ ᎤᏂᏍᎪᎸ
#random: cip=ᏗᏤᎢᏳᏍᏗ, ᏧᏁᎦ, ᏧᏬᏗᎨ, ᏗᎬᎿᎨ, ᏗᏓᎶᏂᎨ, ᏗᏓᎶᏂᎨ ᏧᏍᎪᎸ

#random: ir=ᎩᎦᎨᎢ, ᎩᎨᎢ
#random: ib=ᎬᎿᎨᎢ, ᎬᏂᎨᎢ
#random: ar=ᎠᎩᎦᎨᎢ, ᎠᎩᎨᎢ
#random: ab=ᎠᎬᎿᎨᎢ, ᎠᎬᏂᎨᎢ

[Ꭰ→Ꭱ] ᎦᏙ ᎤᏍᏗ ᎢᏤᎢᏳᏍᏗ ᎩᏟ?	[Ꭱ] ᎯᎠ ᎢᏤᎢᏳᏍᏗ ᎩᏟ (alive) ᎠᎴ ᎯᎠ ᎢᏤᎢᏳᏍᏗ ᎩᏟ (dead).
[Ꭰ→Ꭱ] ᎦᏙ ᎤᏍᏗ ᎤᏁᎦ ᎩᏟ?	[Ꭱ] ᎯᎠ ᎤᏁᎦ ᎩᏟ (alive) ᎠᎴ ᎯᎠ ᎤᏁᎦ ᎩᏟ (dead).
[Ꭰ→Ꭱ] ᎦᏙ ᎤᏍᏗ ᎤᏬᏗᎨ ᎩᏟ?	[Ꭱ] ᎯᎠ ᎤᏬᏗᎨ ᎩᏟ (alive) ᎠᎴ ᎯᎠ ᎤᏬᏗᎨ ᎩᏟ (dead).
[Ꭰ→Ꭱ] ᎦᏙ ᎤᏍᏗ ᎠᎬᎿᎨ ᎩᏟ?	[Ꭱ] ᎯᎠ ᎠᎬᎿᎨ ᎩᏟ.
[Ꭰ→Ꭱ] ᎦᏙ ᎤᏍᏗ ᎠᏓᎶᏂᎨ ᎩᏟ?	[Ꭱ] ᎯᎠ ᎠᏓᎶᏂᎨᎢ ᎩᏟ.
[Ꭰ→Ꭱ] ᎦᏙ ᎤᏍᏗ ᎠᏓᎶᏂᎨ ᎤᏍᎪᎸ ᎩᏟ?	[Ꭱ] ᎯᎠ ᎠᏓᎶᏂᎨᎢ ᎤᏍᎪᎸ ᎩᏟ.

[Ꭰ→Ꭱ] ᎦᏙ ᎤᏍᏗ ᎬᎿᎨ ᎩᏟ?	[Ꭱ] ᎯᎠ ᎬᎿᎨ ᎩᏟ.
[Ꭰ→Ꭱ] ᎦᏙ ᎤᏍᏗ ᏓᎶᏂᎨ ᎩᏟ?	[Ꭱ] ᎯᎠ ᏓᎶᏂᎨ ᎩᏟ.
[Ꭰ→Ꭱ] ᎦᏙ ᎤᏍᏗ ᏓᎶᏂᎨ ᎤᏍᎪᎸ ᎩᏟ?	[Ꭱ] ᎯᎠ ᏓᎶᏂᎨ ᎤᏍᎪᎸ ᎩᏟ.

[Ꭰ→Ꭱ] ᎦᏙ ᎤᎾᏍᏗ ᎠᏂᏤᎢᏳᏍᏗ ᏪᏌ?	[Ꭱ] ᎯᎠ ᎠᏂᏤᎢᏳᏍᏗ ᏪᏌ.
[Ꭰ→Ꭱ] ᎦᏙ ᎤᎾᏍᏗ ᎤᏂᏁᎦ ᏪᏌ?	[Ꭱ] ᎯᎠ ᎤᏂᏁᎦ ᏪᏌ.
[Ꭰ→Ꭱ] ᎦᏙ ᎤᎾᏍᏗ ᏧᏃᏗᎨ ᏪᏌ?	[Ꭱ] ᎯᎠ ᏧᏃᏗᎨ.
[Ꭰ→Ꭱ] ᎦᏙ ᎤᎾᏍᏗ ᎠᏂᎬᎿᎨ ᏪᏌ?	[Ꭱ] ᎯᎠ ᎠᏂᎬᎿᎨ ᏪᏌ.
[Ꭰ→Ꭱ] ᎦᏙ ᎤᎾᏍᏗ ᎠᏂᏓᎶᏂᎨ ᏪᏌ?	[Ꭱ] ᎯᎠ ᎠᏂᏓᎶᏂᎨ ᏪᏌ.
[Ꭰ→Ꭱ] ᎦᏙ ᎤᎾᏍᏗ ᎠᏂᏓᎶᏂᎨ ᎤᏂᏍᎪᎸ ᏪᏌ?	[Ꭱ] ᎯᎠ ᎠᏂᏓᎶᏂᎨ ᎤᏂᏍᎪᎸ ᏪᏌ.

[Ꭰ→Ꭱ] ᎦᏙ ᏧᏍᏗ ᏗᏤᎢᏳᏍᏗ ᏪᏌ?	[Ꭱ] ᎯᎠ ᏗᏤᎢᏳᏍᏗ ᏪᏌ.
[Ꭰ→Ꭱ] ᎦᏙ ᏧᏍᏗ ᏧᏁᎦ ᏪᏌ?	[Ꭱ] ᎯᎠ ᏧᏁᎦ ᏪᏌ.
[Ꭰ→Ꭱ] ᎦᏙ ᏧᏍᏗ ᏧᏬᏗᎨ ᏪᏌ?	[Ꭱ] ᎯᎠ ᏧᏬᏗᎨ.
[Ꭰ→Ꭱ] ᎦᏙ ᏧᏍᏗ ᏗᎬᎿᎨ ᏪᏌ?	[Ꭱ] ᎯᎠ ᏗᎬᎿᎨ ᏪᏌ.
[Ꭰ→Ꭱ] ᎦᏙ ᏧᏍᏗ ᏗᏓᎶᏂᎨ ᏪᏌ?	[Ꭱ] ᎯᎠ ᏗᏓᎶᏂᎨᎢ ᏪᏌ.
[Ꭰ→Ꭱ] ᎦᏙ ᏧᏍᏗ ᏗᏓᎶᏂᎨ ᏧᏍᎪᎸ ᏪᏌ?	[Ꭱ] ᎯᎠ ᏗᏓᎶᏂᎨᎢ ᏧᏍᎪᎸ ᏪᏌ.

ᎢᏤᎢᏳᏍᏗ ᎩᏟ (alive).	[Ꭰ→Ꭱ] ᎦᏙ ᎤᏍᏗ?	[Ꭱ] ᎯᎠ ᎢᏤᎢᏳᏍᏗ ᎩᏟ.
ᎤᏁᎦ ᎩᏟ (alive).	[Ꭰ→Ꭱ] ᎦᏙ ᎤᏍᏗ?	[Ꭱ] ᎯᎠ ᎤᏁᎦ ᎩᏟ.
ᎤᏬᏗᎨ ᎩᏟ (alive).	[Ꭰ→Ꭱ] ᎦᏙ ᎤᏍᏗ?	[Ꭱ] ᎯᎠ ᎤᏬᏗᎨ ᎩᏟ.
ᎠᎬᎿᎨ ᎩᏟ.	[Ꭰ→Ꭱ] ᎦᏙ ᎤᏍᏗ?	[Ꭱ] ᎯᎠ ᎠᎬᎿᎨ ᎩᏟ.
ᎠᏓᎶᏂᎨ ᎩᏟ.	[Ꭰ→Ꭱ] ᎦᏙ ᎤᏍᏗ?	[Ꭱ] ᎯᎠ ᎠᏓᎶᏂᎨᎢ ᎩᏟ.
ᎠᏓᎶᏂᎨ ᎤᏍᎪᎸ ᎩᏟ.	[Ꭰ→Ꭱ] ᎦᏙ ᎤᏍᏗ?	[Ꭱ] ᎯᎠ ᎠᏓᎶᏂᎨᎢ ᎤᏍᎪᎸ ᎩᏟ.

ᎢᏤᎢᏳᏍᏗ ᎩᏟ (dead).	[Ꭰ→Ꭱ] ᎦᏙ ᎤᏍᏗ?	[Ꭱ] ᎯᎠ ᎢᏤᎢᏳᏍᏗ ᎩᏟ.
ᎤᏁᎦ ᎩᏟ (dead).	[Ꭰ→Ꭱ] ᎦᏙ ᎤᏍᏗ?	[Ꭱ] ᎯᎠ ᎤᏁᎦ ᎩᏟ.
ᎤᏬᏗᎨ ᎩᏟ (dead).	[Ꭰ→Ꭱ] ᎦᏙ ᎤᏍᏗ?	[Ꭱ] ᎯᎠ ᎤᏬᏗᎨ ᎩᏟ.
ᎬᎿᎨ ᎩᏟ.	[Ꭰ→Ꭱ] ᎦᏙ ᎤᏍᏗ?	[Ꭱ] ᎯᎠ ᎬᎿᎨ ᎩᏟ.
ᏓᎶᏂᎨ ᎩᏟ.	[Ꭰ→Ꭱ] ᎦᏙ ᎤᏍᏗ?	[Ꭱ] ᎯᎠ ᏓᎶᏂᎨ ᎩᏟ.
ᏓᎶᏂᎨ ᎤᏍᎪᎸ ᎩᏟ.	[Ꭰ→Ꭱ] ᎦᏙ ᎤᏍᏗ?	[Ꭱ] ᎯᎠ ᏓᎶᏂᎨ ᎤᏍᎪᎸ ᎩᏟ.

ᎠᏂᏤᎢᏳᏍᏗ ᏪᏌ.	[Ꭰ→Ꭱ] ᎦᏙ ᎤᎾᏍᏗ?	[Ꭱ] ᎯᎠ ᎠᏂᏤᎢᏳᏍᏗ ᏪᏌ.
ᎤᏂᏁᎦ ᏪᏌ.	[Ꭰ→Ꭱ] ᎦᏙ ᎤᎾᏍᏗ?	[Ꭱ] ᎯᎠ ᎤᏂᏁᎦ ᏪᏌ.
ᏧᏃᏗᎨ ᏪᏌ.	[Ꭰ→Ꭱ] ᎦᏙ ᎤᎾᏍᏗ?	[Ꭱ] ᎯᎠ ᏧᏃᏗᎨ.
ᎠᏂᎬᎿᎨ ᏪᏌ.	[Ꭰ→Ꭱ] ᎦᏙ ᎤᎾᏍᏗ?	[Ꭱ] ᎯᎠ ᎠᏂᎬᎿᎨ ᏪᏌ.
ᎠᏂᏓᎶᏂᎨ ᏪᏌ.	[Ꭰ→Ꭱ] ᎦᏙ ᎤᎾᏍᏗ?	[Ꭱ] ᎯᎠ ᎠᏂᏓᎶᏂᎨ ᏪᏌ.
ᎠᏂᏓᎶᏂᎨ ᎤᏂᏍᎪᎸ ᏪᏌ.	[Ꭰ→Ꭱ] ᎦᏙ ᎤᎾᏍᏗ?	[Ꭱ] ᎯᎠ ᎠᏂᏓᎶᏂᎨ ᎤᏂᏍᎪᎸ ᏪᏌ.

ᏗᏤᎢᏳᏍᏗ ᏪᏌ.	[Ꭰ→Ꭱ] ᎦᏙ ᏧᏍᏗ?	[Ꭱ] ᎯᎠ ᏗᏤᎢᏳᏍᏗ ᏪᏌ.
ᏧᏁᎦ ᏪᏌ.	[Ꭰ→Ꭱ] ᎦᏙ ᏧᏍᏗ?	[Ꭱ] ᎯᎠ ᏧᏁᎦ ᏪᏌ.
ᏧᏬᏗᎨ ᏪᏌ.	[Ꭰ→Ꭱ] ᎦᏙ ᏧᏍᏗ?	[Ꭱ] ᎯᎠ ᏧᏬᏗᎨ.
ᏗᎬᎿᎨ ᏪᏌ.	[Ꭰ→Ꭱ] ᎦᏙ ᏧᏍᏗ?	[Ꭱ] ᎯᎠ ᏗᎬᎿᎨ ᏪᏌ.
ᏗᏓᎶᏂᎨ ᏪᏌ.	[Ꭰ→Ꭱ] ᎦᏙ ᏧᏍᏗ?	[Ꭱ] ᎯᎠ ᏗᏓᎶᏂᎨᎢ ᏪᏌ.
ᏗᏓᎶᏂᎨ ᏧᏍᎪᎸ ᏪᏌ.	[Ꭰ→Ꭱ] ᎦᏙ ᏧᏍᏗ?	[Ꭱ] ᎯᎠ ᏗᏓᎶᏂᎨᎢ ᏧᏍᎪᎸ ᏪᏌ.

